1111111111111111111111111111111111111111111111111111111111111111
1111111111111111111111000100000000011000001000001000001000001111
1000000100000000000001000000000000011000001000001000001000001111
1000X00000000000000001000100000000011000001000001000001000001111
1000000100000000000001000100000000011110111110111110111110111111
1111111111111111000001000100000000011000000000000000000000001111
1000000111111111000001000100000000011000000000000000000000001111
1000000111111111000001000111100000011000000000000000000000001111
1100000100000001000001000000100000011111111100000111111111111111
1111111100001011110111000000000000011000011110001111111111111111
1000000100001001100011000000100000011000011110001111111111111111
1000000000001111100011111000111111111100010010001111111111111111
1000000100001000000000001000000000001100010011011111111111111111
1001100100001000000000001000000000001100010010001111111111111111
1001000100001001100011001000000000001100010010001111111111111111
1001100111111001100011001111111110001111111110001111111111111111
1000000000100000000000000010000010000100000000001111111111111111
1000000000000000000000000000000000000000000000001111111111111111
1000000000100000000000000010000010000100000000001100000000000111
1001100111111001100011001111111111111111111111111000000000000011
1001000100001001100011001111111111111110000000001000000000000011
1001100100001000000000001111111111111110000000000000000000000011
1000000100001000000000001111111111111110010001001000111111100011
1000000000001111100011111111111111111110000000001000111111100011
1000000100001000100011111111111111111110000000001000111100000011
1111111100001000110111111111111111111110010001001000110000100011
1000000100001000100011111111111111111110000000000000110000100011
1000000111111000100011111111111110000010000000001000110000100011
1000001111111101100011111111111110000011011111011000111111100011
1000001000000000000000000000001000000000000000000000000000000011
1000000000000000000000000000000000000000000000000000000000000011
1000001000000000000000000000001000000000000000000000000000000011
1000001111111111100011111111111000000011111111111000111111100011
1000000100000000100010000000000000000010000000001000100000100011
1000000100000000100010000000000000000010000000001000100000100011
1111111100000000110110000000000000000010000000001000100000100011
1000001100000000000010000000000000000010000000001000100000100011
1000001100000000000000000000000000000010000000001000100000100011
1000001100000000000010000000000000000010000000001000111011100011
1000001111111111111110000000000000000010000000001000000000000011
1000000000000000100000001101111011110111011110111000000000000011
1000000000000000000000001000000000000010001000001100000000000111
1000000000000000100000001000000000000010001000001111111111111111
1000001111111111111111111000000000000010001000001111111111111111
1000001111111111111111111100000000000110001000001111111111111111
1000001111111111111111111100000000000110001000001111111111111111
1000001111111111111111111100000000000110001000001111111111111111
1000001111111111111111111000000000000010001000001111111111111111
1110111111111111111111111000000000000000001000001111111111111111
1000001111111111111111111000000000000010001000001111111111111111
1000001111111111111111111111111111111110001000001111111111111111
1000001111111100000000000011000000011110001000001111111111111111
1000001111111100000000000010000000001110001000001111111111111111
1000001111111100000000001100000000000110001000001000000000000111
1111111111111100000000001000000000000010001000000000000000000011
1111111111111100000000001000000000000000001000001000000000000001
1111111111111100000000001000000000000010001111111000000001100001
1111111111111100000000001000000000000010001111001000000001110001
1111111111111100000000001000000000000000001111001000000001110001
1111111111111100000000001000000000000010001100000000000001100001
1111111111111100000000001100000000000110001111001000000000000001
1111111111111111111111111110000000001110001111001000000000000011
1111111111111111111111111111000000011110001111111000000000000111
1111111111111111111111111111111111111111111111111111111111111111
