11111111111111111111111111111111111111111111111111111
11111111111111111111111111111111111111111111111110111
11111111111111100000000000000000000000000000000000011
11111111111111100000010000000000000000000000000000111
11111111111111100110010011111111110111111111111100111
11111111111111100110010011111111100011111111111100111
11111111111111100110010011000011100011100001111100111
11111111111111100110010011000011100011100001111100111
11111111111111100110010011000000000000000001111100111
11111111111111100110010011000000000000000001111100111
11111111111111100110010011110011110111100111111100111
11111111111111100110010011110010000000100110001000111
11111111111111100110010000010010000000100110000000111
11111111111111100110010000010010000000100110001000111
11111111111111100111111110010011111111100110011110111
11111111111111100111111110010000000000000110011111111
11111111111111100000000000010000000000000110011111111
11111111111111100000000000011000000000001110011111111
11111111111111111111111111111100000000011110000000111
11111111111111111110000001111110000000111110000000111
11111111110000000010000000111111110111111111111100111
11111111110000000000000000000000100010000000111100111
11111111110011000010000000000000000000000000111100111
11111000000011111110000000000000100010000000111100111
11111000000011111110000000111111100011111000111100111
11110011110011111111010111111111110011111000111100111
11110011110000000000010011000000010011111000000000111
11110011110000000000010011000000010011111000000000111
11110011111110011111110011001110010011111111101111111
11110011111110011111110011001X10010000011110000011111
11110011110000000000000011001010010000000110000011111
11110011110000000000000011001010010000001111001001111
11110011110011111001110011001000010010111110010011111
11110000000011111001110011001000010011110000010000001
11110000000000111001110011001111110000110000010000001
11110111110000111000000011000000000000110011111111001
11100011111100111000000011000000000001110010000011001
11000001111100111110011111111111111111110010000011001
11000001111100111110011111111111111111110010011000001
10000000111100111110011111111110000000000010011000001
10000000111100000000011111111110000000000010011111111
10000000111100000000011111111110011111111110011111111
10000000111111111111111111111110000000000010000011111
11000001111111111111111111111110000000000010000011111
11100011111111111111111111111110000000000011110011111
11110111111111111111111111111110000000000011110011111
11111111111111111111111111111110000000000011110011111
11111111111111111111111111111110000000000011110011111
11111111111111111111111111111110000000000011110011111
11111111111111111111111111111110000000000000000011111
11111111111111111111111111111110000000000000000011111
11111111111111111111111111111111111111111111111111111
