111111111111111111111111111111111111111
111111110000000011011000000000000000001
100000110000000000001000000000000000001
100000110000000000000000000000X00000001
100000110000000000001000000000000000001
100000111111111111111000000000000000001
100000000000000010000000110111101111011
100000000000000000000000100000000000001
100000000000000010000000100000000000001
100000111111111111111111100000000000001
100000111111111111111111110000000000011
100000111111111111111111110000000000011
100000111111111111111111110000000000011
100000111111111111111111100000000000001
111011111111111111111111100000000000001
100000111111111111111111100000000000001
100000111111111111111111111111111111111
100000111111110000000000001100000001111
100000111111110000000000001000000000111
100000111111110000000000110000000000011
111111111111110000000000100000000000001
111111111111110000000000100000000000001
111111111111110000000000100000000000001
111111111111110000000000100000000000001
111111111111111111111111111111111111111
