1111111111111111111111111111111111111111
10000000000000000000000000000000000X0001
1000000000000000000000000000000000000001
1001001111111111111111111111111111111111
1001001111110000000000000000000000000001
1001001111110000000000000000000000000001
1001000000000011111111111111100000000001
1111000000000011111111111111100000000001
1111111111111111111111111111111111111111
