111111111111111111111111111111111111111
100000000000000000000000000000000000001
100000000000000000000000000000000000001
1000000000000000000X0000000000000000001
100000000000000000000000000000000000001
100000000000000000000000000000000000001
100000000000000000000000000000000000001
111111111111111110000011111111111111111
100010000001111110000010000000000111111
101110111101111100111011111011110111111
100000001100000001000000000000000000011
111101111111111111111111011111111111001
111100000111111111111111010000000000011
100001111111000000000000010111111111111
101111111111011111111111100000000000001
100000000000011111111111101111111111111
101111111111111111111111111111110100001
100000000000011000000001111111110111101
100011111111110000000000111111000011101
111011111111000000000000001111011000001
111011111110000000000000000100001011111
111000000000000000000000000111111011111
111011111111000000000000001110000000111
100011111011110000000000111000111101111
101111111000011000000001111110000000001
100000000011101111111111111110111111111
101111111111100000000000000000000001111
111111111111111111111111111111111111111
