11111111111111111111111111
10000100010000000000100001
10110000010011110000000001
10010X01110010000000100001
10010000000010000000100001
11110011111111111100111111
11100000000011011000000001
11101101111000011011011101
10000000111011100011000001
10111111111111101111111001
10000001110000001110000011
10111100000111011110011111
10000111011111011110001111
10000111011111011111100001
10000111011000011111101101
10000000011011000000000001
11111111111111111111111111
